10 10
**0*******
**0*0*000*
**000**0**
*0**0**0**
*0000000**
****0**0**
**000**00*
**0*******
**0000000*
********E*
0 2
15 20
***********E********
*000000000*0********
***0*****0*0********
*0*0**0**0*000000***
*0000000000*****0***
*0**************0***
*0*00000000000000***
*0**********0*******
*0000000000*0*******
**0**0****0*000000**
*0000000000*0*******
***0*****0**00000***
*000000000******0***
***0**0**0*00000000*
*********0**********
14 9
1 1
0
0 0
1 1
E
0 0
-1 -1